111111111111111111111
123332333212333233321
121212121333121212121
122222223121322222221
131313131333131313131
133333331333333333331
131313131333131313131
122222223121322222221
121212121333121212121
123332333212333233321
111111111111111111111