111111111111111111111
122222222222222222221
122222222222222111221
111111111111121222121
121212121333122122121
133223333333122221221
131212121333122212221
111111111111122222221
122222222222222212221
122222222222222222221
111111111111111111111