111111111111111111111
131333333333231333331
133211112111123311111
121133332133331113331
133331213131111332131
121111133133233312131
133311331311311112131
131333312331323333331
131112111121121111111
133333333332133333131
111111111111111111111