111111111111111111111
133333113332333313331
131112332112111311131
123333113332333313111
131113223131111113311
132123113131133333331
131113223131111113311
123333113332333313111
131112332112111311131
133333113333333313331
111111111111111111111