111111111111111111111
133323333313333323331
131121121323121121131
131333121121121333131
123313333323333313321
112122112111211221211
123313333323333313321
131333121121121333131
131121121323121121131
133323333313333323331
111111111111111111111