111111111111111111111
133333333333333333331
133333333333333333331
133333333333333333331
133333333333333333331
133333333333333333331
133333333333333333331
133333333333333333331
133333333333333333331
133333333333333333331
111111111111111111111