111111111111111111111
133333333313333333331
131131131333131131131
131333133111331333131
133313333333333313331
113133133111331331311
133313333333333313331
131333133111331333131
131131131333131131131
133333333313333333331
111111111111111111111